0,0,0,0,0,0,0,0,0,0,0,0,0,0,0,0,0,0,0,0,0,0,0,0,0,0,0,0,0,0,0,0,0,0,0,0,0,0,0,0,0,0,0,0,0,0,0,0,0,0,0,0,0,0,0,0,0,0,0,0,0,0,0,0,0,0,0,0,0,0,0,0,0,0,0,0,0,0,0,0,0,0,0,0,0,0,0,0,0,0,0,0,0,0,0,0,0,0,0,0,0,0,0,0,0,0,0,0,0,0,0,0,0,0,0,0,0,0,0,0,0,0,0,0,0,0,0,0,0,0,0,0,0,0,0,0,0,0,0,0,0,0,0,0,0,0,0,0,0,0,0,0,0,0,0,0,0,0,0,0,0,0,0,0,0,0,0,0,0,0,0,0,0,0,0,0,0,0,0,0,0,0,0,0,0,0,0,0,0,0,0,0,0,0,0,0,0,0,0,0,0,0,0,0,0,0,0,0,0,0,0,0
0,0,0,0,0,0,0,0,0,0,0,0,0,0,0,0,0,0,0,0,0,0,0,0,0,0,0,0,0,0,0,0,0,0,0,0,0,0,0,0,0,0,0,0,0,0,0,0,0,0,0,0,0,0,0,0,0,0,0,0,0,0,0,0,0,0,0,0,0,0,0,0,0,0,0,0,0,0,0,0,0,0,0,0,0,0,0,0,0,0,0,0,0,0,0,0,0,0,0,0,0,0,0,0,0,0,0,0,0,0,0,0,0,0,0,0,0,0,0,0,0,0,0,0,0,0,0,0,0,0,0,0,0,0,0,0,0,0,0,0,0,0,0,0,0,0,0,0,0,0,0,0,0,0,0,0,0,0,0,0,0,0,0,0,0,0,0,0,0,0,0,0,0,0,0,0,0,0,0,0,0,0,0,0,0,0,0,0,0,0,0,0,0,0,0,0,0,0,0,0,0,0,0,0,0,0,0,0,0,0,0,0
0,0,0,0,0,0,0,0,0,0,0,0,0,0,0,0,0,0,0,0,0,0,0,0,0,1,2,2,3,0,0,0,0,0,0,0,0,0,0,0,0,0,0,0,0,0,0,0,0,0,0,0,1,2,4,0,0,0,0,0,0,0,0,0,0,0,0,0,0,0,0,0,0,0,0,0,0,0,0,0,0,0,5,2,2,4,0,0,0,0,0,0,0,0,0,0,0,0,0,0,0,0,0,0,0,0,0,0,0,0,0,0,0,0,0,0,0,0,0,0,0,0,0,0,0,0,0,0,0,0,0,0,0,0,0,0,0,0,0,0,0,0,0,0,0,0,0,0,0,0,0,0,0,0,0,0,0,0,0,0,0,0,0,0,0,0,0,0,0,0,0,0,0,1,2,2,3,0,0,0,0,0,0,0,0,0,0,0,0,0,0,0,0,0,0,0,0,0,0,0,1,2,4,0,0,0,0,0,0,0,0,0
0,0,0,0,0,0,0,0,0,0,0,0,0,0,0,0,0,0,0,0,0,0,0,0,1,6,7,8,9,3,0,0,0,0,0,0,0,0,0,0,0,0,0,0,0,0,0,0,0,0,0,1,6,10,9,3,0,0,0,0,0,0,0,0,0,0,0,0,0,0,0,0,0,0,0,0,0,0,0,0,0,0,11,7,8,12,0,0,0,13,14,15,0,0,0,0,0,0,0,0,0,0,0,0,0,0,0,0,0,0,0,0,0,0,0,0,0,0,0,0,0,0,0,0,0,0,0,0,0,0,0,0,0,0,0,0,0,0,0,0,0,0,0,0,0,0,0,0,0,0,0,0,0,0,0,0,0,0,0,0,0,0,0,0,0,0,0,0,0,0,0,0,1,6,7,8,9,3,0,0,0,0,0,0,0,0,0,0,0,0,0,0,0,0,13,14,15,0,0,1,6,10,9,3,0,0,0,0,0,0,0,0
16,16,16,16,16,16,16,16,16,16,16,16,16,16,16,16,16,16,16,16,16,16,16,16,17,18,19,19,20,21,16,16,16,16,16,16,22,23,16,16,24,23,16,16,16,16,16,16,16,16,16,25,19,19,20,21,16,16,26,16,16,16,16,16,16,16,16,16,16,22,23,16,16,16,16,16,16,16,16,16,16,16,17,27,27,21,16,16,28,29,30,31,32,16,16,16,16,16,16,16,16,16,16,16,16,16,16,16,22,23,16,16,16,16,16,16,16,16,16,22,33,16,16,16,16,16,16,16,16,16,16,16,16,16,16,22,33,16,16,16,16,16,16,16,16,16,16,16,16,16,16,16,16,16,16,16,16,16,16,16,16,16,16,16,16,16,16,16,16,16,16,16,17,18,19,19,20,21,16,16,16,16,16,16,22,23,16,16,24,23,16,16,16,28,29,30,31,32,16,34,19,19,20,21,16,16,26,16,16,16,16,16
35,35,35,35,35,35,35,35,35,35,35,35,35,35,35,35,35,35,35,35,35,35,35,35,35,36,37,37,38,35,35,35,35,35,35,39,40,41,42,43,6,9,42,43,44,42,35,35,35,35,35,35,45,37,46,35,35,39,47,48,35,35,35,35,35,35,35,35,39,6,9,42,35,35,35,35,35,35,35,35,35,35,35,35,35,35,35,49,50,30,30,51,52,53,35,35,35,35,35,35,35,35,35,35,35,35,39,54,6,9,55,35,35,43,44,48,35,35,39,19,56,35,35,35,35,35,35,35,35,35,35,35,35,43,44,19,9,48,35,35,35,35,35,35,35,35,35,35,35,35,35,35,35,35,35,35,35,35,35,35,35,35,35,35,35,35,35,35,35,35,35,35,35,36,37,37,38,35,35,35,35,35,35,39,40,41,42,43,6,57,57,43,58,59,30,30,60,61,53,35,45,37,46,35,35,39,47,48,35,35,35,35
62,62,62,62,62,62,63,64,65,62,63,65,62,62,62,62,62,62,62,62,62,62,62,62,62,62,62,62,62,62,62,62,62,62,62,66,19,19,9,67,19,19,68,6,10,9,65,62,62,62,62,62,62,62,62,62,62,69,19,9,70,62,62,62,62,62,62,63,6,7,8,9,65,62,63,64,70,62,62,62,62,62,62,62,62,62,71,72,30,30,73,74,75,76,77,62,62,62,62,62,62,62,62,62,62,63,6,19,7,8,78,79,63,6,19,9,70,63,80,19,9,70,62,62,62,62,62,62,62,62,62,62,81,6,19,19,19,9,70,62,62,62,62,62,62,62,62,62,62,62,62,62,62,62,63,64,65,62,63,65,62,62,62,62,62,62,62,62,62,62,62,62,62,62,62,62,62,62,62,62,62,62,62,66,19,19,9,67,57,57,57,82,83,30,30,73,74,75,76,77,62,62,62,62,62,69,19,9,70,62,62,62
84,84,84,84,84,85,6,10,9,86,6,9,87,88,84,84,84,84,84,84,84,84,84,84,84,84,84,84,84,84,84,84,84,84,84,89,18,19,19,9,19,19,6,19,19,19,90,84,84,84,84,84,84,91,92,93,94,6,19,19,90,84,84,84,84,84,84,89,18,19,19,19,9,86,6,10,9,95,84,84,84,84,84,84,94,96,97,30,30,30,98,30,30,99,100,101,84,84,84,84,84,84,84,84,84,102,19,19,19,19,19,9,6,19,10,19,9,6,6,19,19,68,95,84,84,84,84,84,84,84,84,94,6,19,19,10,19,20,103,84,84,84,84,84,84,84,84,84,84,84,84,84,84,85,6,10,9,86,104,105,106,88,84,84,84,84,84,84,84,84,84,84,84,84,84,84,84,84,84,84,84,84,84,89,18,19,19,57,57,57,57,107,30,30,30,98,30,30,108,100,101,84,84,84,94,6,19,19,90,84,84,84
109,109,109,109,109,110,18,19,20,111,19,19,19,9,112,109,113,114,114,115,109,109,109,109,109,109,109,109,109,109,109,109,109,109,109,113,6,19,19,19,19,19,19,19,19,20,116,109,109,109,109,109,117,118,73,119,120,19,19,20,116,109,109,109,109,109,109,113,121,19,19,19,20,111,19,19,19,122,109,109,109,109,109,113,82,83,123,124,30,30,30,125,126,127,128,129,130,109,109,109,109,109,109,109,113,6,19,19,19,19,19,131,19,19,132,19,19,19,19,68,133,6,9,115,109,109,109,109,109,109,109,110,18,19,19,19,19,9,112,134,115,109,109,109,109,109,109,109,109,109,109,109,109,110,18,19,20,135,136,73,137,138,112,109,113,114,114,115,109,109,109,109,109,109,109,109,109,109,109,109,109,109,109,113,6,19,57,57,57,57,57,123,124,30,30,30,125,126,139,140,141,142,143,114,144,145,146,147,116,109,109,109
148,148,148,148,149,150,6,19,19,19,19,19,19,19,9,151,152,7,8,9,153,154,155,148,148,148,148,148,148,148,148,148,148,148,148,156,19,19,19,19,19,19,19,20,157,158,159,160,148,148,148,161,162,30,98,163,164,165,166,167,168,155,148,148,148,148,149,6,6,19,19,19,19,19,19,19,169,170,171,148,148,148,148,172,107,30,173,174,30,30,30,175,176,30,177,178,179,180,148,148,148,148,148,149,6,19,19,19,19,181,182,183,19,19,19,19,19,19,184,6,19,7,8,9,185,186,154,155,148,148,148,148,156,68,6,19,19,19,57,6,187,57,151,185,148,148,148,148,148,148,148,148,57,57,6,19,57,107,30,98,163,164,138,151,104,188,189,9,185,148,148,148,148,148,148,148,148,148,148,148,148,148,148,156,19,57,57,57,57,57,57,173,174,30,30,30,175,176,30,75,190,191,192,133,193,194,195,196,197,148,148,148
148,148,148,198,6,199,200,201,19,19,19,19,184,67,19,19,202,19,19,203,136,123,204,180,148,148,148,148,148,148,148,148,148,148,149,104,200,201,205,166,19,19,20,158,148,148,206,207,148,186,208,209,210,125,126,211,75,212,213,136,30,204,180,148,148,148,156,19,19,19,19,19,68,133,214,200,201,19,9,197,148,148,215,216,30,30,30,30,30,210,217,30,30,30,30,108,218,179,180,148,148,148,148,219,18,19,19,19,19,220,221,222,201,19,19,19,19,19,6,19,19,19,19,19,223,224,123,204,180,148,148,148,219,80,19,19,19,57,57,67,225,57,57,9,197,148,148,148,148,148,148,57,57,57,199,226,57,57,125,126,211,75,227,228,136,30,137,229,158,148,148,148,148,148,148,148,148,148,148,186,154,155,149,6,57,57,57,57,57,57,57,30,30,30,210,217,30,30,30,30,108,218,191,230,231,232,233,234,235,185,148,148
148,148,149,6,203,136,123,137,236,19,19,68,40,41,67,19,19,19,203,107,30,173,139,237,180,148,148,148,159,160,148,148,148,148,172,136,123,137,238,239,19,19,68,151,197,148,206,207,215,240,30,241,242,175,176,30,123,243,244,30,30,139,237,180,148,198,6,19,19,19,19,184,6,245,136,124,137,236,20,158,148,215,246,30,30,30,30,30,247,248,249,30,30,30,250,139,140,251,179,252,151,185,148,148,219,18,19,19,19,203,136,123,137,236,19,19,19,19,19,19,19,19,19,203,107,30,173,139,237,180,148,148,149,6,19,19,57,57,57,223,253,57,57,57,9,185,148,148,148,148,57,57,57,57,136,30,57,57,57,176,30,123,254,255,256,257,139,164,258,148,148,148,148,148,148,148,148,148,215,240,259,260,261,57,57,57,57,57,57,57,57,30,30,247,248,249,30,30,30,250,139,140,251,262,263,264,265,266,267,9,197,148
148,148,156,203,107,30,173,139,164,192,133,268,269,269,270,271,19,203,107,73,30,30,250,272,273,274,148,148,206,207,148,148,148,275,276,30,173,139,277,239,19,278,279,269,280,185,206,281,246,123,30,139,282,242,30,30,283,284,244,285,286,286,287,288,180,289,18,19,19,19,19,290,291,292,210,174,139,164,138,197,215,246,30,30,30,30,30,30,293,294,286,286,295,30,211,296,75,297,298,191,299,9,185,148,198,6,19,19,278,300,286,301,302,164,236,19,19,19,19,19,278,269,303,107,73,30,30,250,75,304,180,148,219,18,19,57,57,57,57,300,286,57,57,57,57,9,197,148,148,57,57,57,57,57,123,30,57,57,57,57,295,283,305,30,243,244,30,75,306,307,308,148,148,148,148,148,148,215,246,210,309,310,57,57,57,57,57,57,57,57,57,30,30,293,311,30,30,30,30,57,296,75,297,312,313,314,315,316,317,19,9,185
318,318,318,318,318,318,318,318,318,318,318,318,318,318,318,318,318,318,318,318,318,318,318,318,318,318,318,318,318,318,318,318,318,318,318,318,318,318,318,318,318,318,318,318,318,318,318,318,318,318,318,318,318,318,318,318,318,318,318,318,318,318,318,318,318,318,318,318,319,19,19,320,318,318,318,318,318,318,318,318,318,318,318,318,318,321,30,30,30,322,318,318,318,318,318,318,318,318,318,318,318,318,318,318,318,318,318,318,318,318,318,318,318,318,318,318,318,318,318,318,318,318,318,318,318,318,318,318,318,318,318,318,318,318,318,318,318,318,318,318,318,318,318,318,318,318,318,318,318,318,318,318,318,321,173,30,322,318,318,318,318,318,318,318,318,318,318,318,318,318,318,318,318,318,318,318,318,318,318,318,318,318,318,318,318,318,318,318,318,318,318,318,318,318,318,318,318,318,318,318,318,318,318,318,318,318,318,318,318,318,318,318
323,323,323,323,323,323,323,323,323,323,323,323,323,323,323,323,323,323,323,323,323,323,323,323,323,323,323,323,323,323,323,323,323,323,323,323,323,323,323,323,323,323,323,323,323,323,323,323,323,323,323,323,323,323,323,323,323,323,323,323,323,323,323,323,323,323,323,323,324,19,203,325,323,323,323,323,323,323,323,323,323,323,323,323,323,326,30,30,30,327,323,323,323,323,323,323,323,323,323,323,323,323,323,323,323,323,323,323,323,323,323,323,323,323,323,323,323,323,323,323,323,323,323,323,323,323,323,323,323,323,323,323,323,323,323,323,323,323,323,323,323,323,323,323,323,323,323,323,323,323,323,323,323,326,30,250,327,323,323,323,323,323,323,323,323,323,323,323,323,323,323,323,323,323,323,323,323,323,323,323,323,323,323,323,323,323,323,323,323,323,323,323,323,323,323,323,323,323,323,323,323,323,323,323,323,323,323,323,323,323,323,323